1,1,1,1,1,1,1
1,1,1,8,1,1,1
1,1,1,8,1,1,1
1,8,8,8,0,0,1
1,1,1,8,1,1,1
1,1,1,8,1,1,1
1,1,1,1,1,1,1
